"filename", "language", "TypeScript", "comment", "blank", "total"
"/Users/waheguru-ji/Projects/Nodejs Apps/Telegram Related /Tg Bots/store shopping bots/CERTII-Games-Code-storeTGBot/src/app.ts", "TypeScript", 2, 0, 0, 2
"/Users/waheguru-ji/Projects/Nodejs Apps/Telegram Related /Tg Bots/store shopping bots/CERTII-Games-Code-storeTGBot/src/conversation/addItems.ts", "TypeScript", 124, 2, 33, 159
"/Users/waheguru-ji/Projects/Nodejs Apps/Telegram Related /Tg Bots/store shopping bots/CERTII-Games-Code-storeTGBot/src/conversation/refund.ts", "TypeScript", 49, 1, 14, 64
"/Users/waheguru-ji/Projects/Nodejs Apps/Telegram Related /Tg Bots/store shopping bots/CERTII-Games-Code-storeTGBot/src/handlers/action.ts", "TypeScript", 5, 0, 0, 5
"/Users/waheguru-ji/Projects/Nodejs Apps/Telegram Related /Tg Bots/store shopping bots/CERTII-Games-Code-storeTGBot/src/handlers/actions/Refund.ts", "TypeScript", 47, 1, 12, 60
"/Users/waheguru-ji/Projects/Nodejs Apps/Telegram Related /Tg Bots/store shopping bots/CERTII-Games-Code-storeTGBot/src/handlers/actions/SubCategory.ts", "TypeScript", 77, 4, 17, 98
"/Users/waheguru-ji/Projects/Nodejs Apps/Telegram Related /Tg Bots/store shopping bots/CERTII-Games-Code-storeTGBot/src/handlers/actions/deposit.ts", "TypeScript", 43, 0, 12, 55
"/Users/waheguru-ji/Projects/Nodejs Apps/Telegram Related /Tg Bots/store shopping bots/CERTII-Games-Code-storeTGBot/src/handlers/actions/purchaseItem.ts", "TypeScript", 40, 1, 10, 51
"/Users/waheguru-ji/Projects/Nodejs Apps/Telegram Related /Tg Bots/store shopping bots/CERTII-Games-Code-storeTGBot/src/handlers/commands.ts", "TypeScript", 2, 0, 0, 2
"/Users/waheguru-ji/Projects/Nodejs Apps/Telegram Related /Tg Bots/store shopping bots/CERTII-Games-Code-storeTGBot/src/handlers/commands/admin/addItems.ts", "TypeScript", 3, 0, 0, 3
"/Users/waheguru-ji/Projects/Nodejs Apps/Telegram Related /Tg Bots/store shopping bots/CERTII-Games-Code-storeTGBot/src/handlers/commands/help.ts", "TypeScript", -5, 0, -1, -6
"/Users/waheguru-ji/Projects/Nodejs Apps/Telegram Related /Tg Bots/store shopping bots/CERTII-Games-Code-storeTGBot/src/helpers/Wallet.ts", "TypeScript", 47, 1, 4, 52
"/Users/waheguru-ji/Projects/Nodejs Apps/Telegram Related /Tg Bots/store shopping bots/CERTII-Games-Code-storeTGBot/src/helpers/env.ts", "TypeScript", -1, 0, 0, -1
"/Users/waheguru-ji/Projects/Nodejs Apps/Telegram Related /Tg Bots/store shopping bots/CERTII-Games-Code-storeTGBot/src/helpers/errorHanlder.ts", "TypeScript", 3, 0, 1, 4
"/Users/waheguru-ji/Projects/Nodejs Apps/Telegram Related /Tg Bots/store shopping bots/CERTII-Games-Code-storeTGBot/src/helpers/session.ts", "TypeScript", 4, 0, 0, 4
"/Users/waheguru-ji/Projects/Nodejs Apps/Telegram Related /Tg Bots/store shopping bots/CERTII-Games-Code-storeTGBot/src/middlewares/attachUser.ts", "TypeScript", 0, 0, 1, 1
"/Users/waheguru-ji/Projects/Nodejs Apps/Telegram Related /Tg Bots/store shopping bots/CERTII-Games-Code-storeTGBot/src/models/Categories.ts", "TypeScript", 5, 1, 1, 7
"/Users/waheguru-ji/Projects/Nodejs Apps/Telegram Related /Tg Bots/store shopping bots/CERTII-Games-Code-storeTGBot/src/models/Items.ts", "TypeScript", 20, 1, 4, 25
"/Users/waheguru-ji/Projects/Nodejs Apps/Telegram Related /Tg Bots/store shopping bots/CERTII-Games-Code-storeTGBot/src/models/User.ts", "TypeScript", 27, 3, 4, 34
"Total", "-", 492, 15, 112, 619